11111111111111111111111111111
1X00000000000C0000000000C0001
10C010C0001000001000001000001
1001010001010C01010C010100C01
1E100010100010100010100010001
1100000100E0000000000000010P1
11111111111111111111111111111