11111111111111111111111111111
100000E00000C0000000000C00011
10C11111111111111111110100C01
10100010100010100010100010001
110000010010010000010000010G1
11111111111111111111111111111