1111111111111111111111111111111
1G00C00C0000C000000C00000000E01
10C00C000C000C000C0000C00C00001
10000C000C000X000000000000C0001
100C0000C00000C0000C00C00111111
111111111111000000P00C000001111
1111111111111111111111111111111