1111111111111111111111111111111
1G00C00C0000C000000C00000000E01
10C00C000C000C000C0000C00C00001
10000C000C000X000000000000C0001
100C0000C00000C0000C00C00111111
111111111111000000000C000001111
10000C00000000C0111111111111111
100000000C0000P00000000000C0111
1111111000000000000000011111111
1111111111111111111111111111111