1111111111111111111111111111111
1000000C00000000000000000000E01
1000000000000000000000000000001
1000000000000X00000000000000001
1000000000000000000000000111111
111111111111000000000C000001111
10000C0000000000111111111111111
100000000C0000000000000000C0111
1111111000000000000000011111111
1C0000000000000C000000000000011
1000000000C000000000000C0011111
100000C000000000011111110001111
1000000000000000000000000001111
1000000P0111100G000C00000001111
10C0000001111000000000000C01111
1111111111111111111111111111111