11111111111111111111111111111
111110C00000C00000C00000000C1
11110010000010000010000010001
111001110C01110C01110C0111001
11001111101111101111101111101
1G0111111111111111111111111E1
11111111111111111111111111111
1X00000000000C0000000000C0001
10C010C0001000001000001000001
1001010001010C01010C010100C01
10100010100010100010100010001
110000010000010000010000010P1
11111111111111111111111111111