111111111111111111111111
111110000000E00000111101
100000000000000000000001
100000000000000000000001
111110000000111100000001
111111100000001111000001
10000C000001111000000001
111111111000111100000C01
111111111000111100000001
111110000000000000000001
111110000000000000011101
111110000011110000011101
11111000001111110000C001
111110000000111111110001
111111111000000001111001
100000000000000000000001
1C0001111111101111000001
100000000000000001111101
100001111000000000011111
100000000000000111111111
111111111000011111111001
110000011000011111111001
1111111100P0011111111001
111111111111111111111111