
1111111
1000011
1PCE001
1111111
