11111
10001
10P01
10001
100E1
11111