1111111
10C0011
1111111

1111111
1PCE001
1111111
