11111
100C1
10P01
1K001
100E1
11111
