11111
10001
10P01
10001
100C1
11111