11111
100C1
10P01
1X001
100E1
11111